剪切: C-w
复制: M-w
粘贴: C-y

上一行: C-p
下一行: C-n
左移一个字符: C-b
右移一个字符: C-f
左移一个单词: M-b
右移一个单词: M-f
行首: C-a
行尾: C-e

文章开头: M-S-,
文章结尾: M-S-.

向上搜索: C-r
向下搜索: C-s
替换：M-S-5

撤销: C-x u
保存: C-x s
保存，不提示: C-x C-s

全选: C-x h
退出: C-x C-c

取消: C-g

切分成两个窗口: C-x 2
关闭其他窗口: C-x 1
切换窗口: C-x o

M-x list-packages

求值当前表达式: C-x C-e
查询键位绑定的函数: C-h k

下一页: C-v
上一页: M-v

剪切上一个单词: M-BackSpace
剪切下一个单词: M-d
剪切光标到行尾: C-k
删除下一个字符: C-d

显示所有buffer：C-mouse
上一个buffer：C-x left
下一个buffer：C-x right
关闭当前buffer：C-x k
